sfxLand="sfxLand"
sfxLandClassic="sfxLandClassic"
sfxHit="sfxHit"
sfxCharging="sfxCharging"
sfxCharged="sfxCharged"
sfxProtoCharging="sfxProtoCharging"
sfxDeath="sfxDeath"
sfxDeathClassic="sfxDeathClassic"
sfxAbsorb="sfxAbsorb"
sfxTeleportIn="sfxTeleportIn"
sfxTeleportInClassic="sfxTeleportInClassic"
sfxTeleportOut="sfxTeleportOut"
sfxTeleportOutClassic="sfxTeleportOutClassic"
sfxSplash="sfxSplash"
sfxWeaponSwitch="sfxWeaponSwitch"
sfxWhistle="sfxWhistle"
sfxExplosion="sfxExplosion"
sfxExplosion2="sfxExplosion2"
sfxClassicExplosion="sfxClassicExplosion"
sfxMM3Explode="sfxMM3Explode"
sfxMM9Explosion="sfxMM9Explosion"
sfxMinorExplosion="sfxMinorExplosion"
sfxEnemyBoost="sfxEnemyBoost"
sfxEnemyDrop="sfxEnemyDrop"
sfxEnemyDrop2="sfxEnemyDrop2"
sfxEnemyHit="sfxEnemyHit"
sfxEnemyHitOld="sfxEnemyHitOld"
sfxEnemyShoot="sfxEnemyShoot"
sfxEnemyShootClassic="sfxEnemyShootClassic"
sfxHeavyLand="sfxHeavyLand"
sfxHeavyLandOLD="sfxHeavyLandOLD"
sfxBlockZap="sfxBlockZap"
sfxCutManSnip="sfxCutManSnip"
sfxFireManFireStorm="sfxFireManFireStorm"
sfxGutsQuake="sfxGutsQuake"
sfxRollingCutter="sfxRollingCutter"
sfxAcidDrop="sfxAcidDrop"
sfxAirShooter="sfxAirShooter"
sfxCrashBombArm="sfxCrashBombArm"
sfxCrashBomb="sfxCrashBomb"
sfxHeatManTackle="sfxHeatManTackle"
sfxMechaDragon="sfxMechaDragon"
sfxWilyUFO="sfxWilyUFO"
sfxBikkyLand="sfxBikkyLand"
sfxBoltonAndNutton="sfxBoltonAndNutton"
sfxCannonShoot="sfxCannonShoot"
sfxElecnShoot="sfxElecnShoot"
sfxHardManLand="sfxHardManLand"
sfxMissileLaunch="sfxMissileLaunch"
sfxNitronFire="sfxNitronFire"
sfxShadowBlade="sfxShadowBlade"
sfxWanaan="sfxWanaan"
sfxDachoneLaser="sfxDachoneLaser"
sfxDachoneWalk="sfxDachoneWalk"
sfxDarkWhistle="sfxDarkWhistle"
sfxFallNoise="sfxFallNoise"
sfxMetallCannon="sfxMetallCannon"
sfxMetallTrain="sfxMetallTrain"
sfxPowerLand="sfxPowerLand"
sfxPowerStomp="sfxPowerStomp"
sfxTaban="sfxTaban"
sfxTeckyun="sfxTeckyun"
sfxTigerRoar="sfxTigerRoar"
sfxBlizzardAttack="sfxBlizzardAttack"
sfxBlizzardCharge="sfxBlizzardCharge"
sfxBlizzardSlam="sfxBlizzardSlam"
sfxCentaurFlash="sfxCentaurFlash"
sfxCentaurTeleport="sfxCentaurTeleport"
sfxCentaurWalk="sfxCentaurWalk"
sfxColtonShoot="sfxColtonShoot"
sfxCurlingerBounce="sfxCurlingerBounce"
sfxCyberGabyoallBoost="sfxCyberGabyoallBoost"
sfxHeliButonHover="sfxHeliButonHover"
sfxHeliButonReveal="sfxHeliButonReveal"
sfxTeck="sfxTeck"
sfxStegorusStomp="sfxStegorusStomp"
sfxStegorusSpikes="sfxStegorusSpikes"
sfxStegorusMissile="sfxStegorusMissile"
sfxTelTelRain="sfxTelTelRain"
sfxAlarm="sfxAlarm"
sfxBalloonboo="sfxBalloonboo"
sfxBunbyCatcher="sfxBunbyCatcher"
sfxChangkeyDragonBreath="sfxChangkeyDragonBreath"
sfxElectricShot="sfxElectricShot"
sfxFireTotemFire="sfxFireTotemFire"
sfxHoohooRock="sfxHoohooRock"
sfxJumpRollerFlame="sfxJumpRollerFlame"
sfxMM9Quake="sfxMM9Quake"
sfxPaozoSuckIn="sfxPaozoSuckIn"
sfxPopoHeliFire="sfxPopoHeliFire"
sfxSharkLaser="sfxSharkLaser"
sfxSplashSing="sfxSplashSing"
sfxBallBounce="sfxBallBounce"
sfxBalladeCrackerExplosion="sfxBalladeCrackerExplosion"
sfxBalladeMine="sfxBalladeMine"
sfxBalladeShoot="sfxBalladeShoot"
sfxBariIIIRegen="sfxBariIIIRegen"
sfxBariIIIShoot="sfxBariIIIShoot"
sfxBlockDevilLaser="sfxBlockDevilLaser"
sfxBombPotton="sfxBombPotton"
sfxChillSpikeLand="sfxChillSpikeLand"
sfxChillSpikeShatter="sfxChillSpikeShatter"
sfxChillShoot="sfxChillShoot"
sfxCommandoBombExplode="sfxCommandoBombExplode"
sfxCommandoBombLaunch="sfxCommandoBombLaunch"
sfxCommandoBombTurn="sfxCommandoBombTurn"
sfxCommandoQuake="sfxCommandoQuake"
sfxCommandoWaveEnd="sfxCommandoWaveEnd"
sfxEnkerCharge="sfxEnkerCharge"
sfxEnkerShot="sfxEnkerShot"
sfxEnkerShotBig="sfxEnkerShotBig"
sfxGarinkou="sfxGarinkou"
sfxJetEggLaunch="sfxJetEggLaunch"
sfxHonk="sfxHonk"
sfxHaikerNShoot="sfxHaikerNShoot"
sfxKaonaToss="sfxKaonaToss"
sfxMechaPitchanDrop="sfxMechaPitchanDrop"
sfxMerserker="sfxMerserker"
sfxNumetallShoot="sfxNumetallShoot"
sfxOctobulbEnergy="sfxOctobulbEnergy"
sfxOctobulbShoot="sfxOctobulbShoot"
sfxPiledan="sfxPiledan"
sfxPointanMake="sfxPointanMake"
sfxPointanSelect="sfxPointanSelect"
sfxPunkEntrance="sfxPunkEntrance"
sfxScrewCrusher="sfxScrewCrusher"
sfxSearchyFound="sfxSearchyFound"
sfxSearchyLight="sfxSearchyLight"
sfxSFDash="sfxSFDash"
sfxSFFlame="sfxSFFlame"
sfxSola0Shoot="sfxSola0Shoot"
sfxSolarBlazeLarge="sfxSolarBlazeLarge"
sfxSolarBlazeSmall="sfxSolarBlazeSmall"
sfxSolarBlazePopLarge="sfxSolarBlazePopLarge"
sfxSolarBlazePopSmall="sfxSolarBlazePopSmall"
sfxSolarManSun="sfxSolarManSun"
sfxSprinklanShoot="sfxSprinklanShoot"
sfxTackleFireDispenser="sfxTackleFireDispenser"
sfxTheKeeperFistClash="sfxTheKeeperFistClash"
sfxTheKeeperShockwave="sfxTheKeeperShockwave"
sfxTsurareStamp="sfxTsurareStamp"
sfxYonbain="sfxYonbain"
sfxGlooperFire="sfxGlooperFire"
sfxLECBubble="sfxLECBubble"
sfxKomusoDoppler="sfxKomusoDoppler"
sfxKomusoFireTower="sfxKomusoFireTower"
sfxKomusoShot="sfxKomusoShot"
sfxSonicManSonicMine="sfxSonicManSonicMine"
sfxCountBomb="sfxCountBomb"
sfxYokuBlock="sfxYokuBlock"
sfxGutsLift="sfxGutsLift"
sfxRushingWater="sfxRushingWater"
sfxQuickLaser="sfxQuickLaser"
sfxCricket="sfxCricket"
sfxGravityFlip="sfxGravityFlip"
sfxTrainBump="sfxTrainBump"
sfxWaveManPipe="sfxWaveManPipe"
sfxFan="sfxFan"
sfxOil="sfxOil"
sfxSpring="sfxSpring"
sfxJumpJump="sfxJumpJump"
sfxSlideSlide="sfxSlideSlide"
sfxConcretePlatformDown="sfxConcretePlatformDown"
sfxConcretePlatformUp="sfxConcretePlatformUp"
sfxHornetRoll="sfxHornetRoll"
sfxJewelPlatform="sfxJewelPlatform"
sfxMagmaBeam="sfxMagmaBeam"
sfxPortal="sfxPortal"
sfxCommandoSandstorm="sfxCommandoSandstorm"
sfxCompactor="sfxCompactor"
sfxChillCrack="sfxChillCrack"
sfxChillBreak="sfxChillBreak"
sfxSheepBlock="sfxSheepBlock"
sfxSheepPlatform="sfxSheepPlatform"
sfxStrikeManSoccerBall="sfxStrikeManSoccerBall"
sfxSidewayElevatorButton="sfxSidewayElevatorButton"
sfxBladeManSeeSawCart1="sfxBladeManSeeSawCart1"
sfxBladeManSeeSawCart2="sfxBladeManSeeSawCart2"
sfxBladeManSeeSawCart3="sfxBladeManSeeSawCart3"
sfxAstroWallBwoop="sfxAstroWallBwoop"
sfxBolt="sfxBolt"
sfxImportantItem="sfxImportantItem"
sfxEnergyRestore="sfxEnergyRestore"
sfxYasichi="sfxYasichi"
sfxSkullAmulet="sfxSkullAmulet"
sfxElementGrab="sfxElementGrab"
sfxKeyGet="sfxKeyGet"
sfxKeySpawn="sfxKeySpawn"
sfxBuster="sfxBuster"
sfxBusterHalfCharged="sfxBusterHalfCharged"
sfxBusterCharged="sfxBusterCharged"
sfxBusterProtoCharged="sfxBusterProtoCharged"
sfxReflect="sfxReflect"
sfxSparkChaser="sfxSparkChaser"
sfxLaserTrident="sfxLaserTrident"
sfxTornadoBlow="sfxTornadoBlow"
sfxWaterShield="sfxWaterShield"
sfxWaterShield2="sfxWaterShield2"
sfxThunderBeam="sfxThunderBeam"
sfxBreakDash="sfxBreakDash"
sfxIceWall="sfxIceWall"
sfxRushCycle1="sfxRushCycle1"
sfxRushCycle2="sfxRushCycle2"
sfxTopSpin="sfxTopSpin"
sfxMetalBlade="sfxMetalBlade"
sfxPharaohShot="sfxPharaohShot"
sfxPharaohShotCharged="sfxPharaohShotCharged"
sfxMagicCard="sfxMagicCard"
sfxThunderWoolRise="sfxThunderWoolRise"
sfxThunderWoolThunder="sfxThunderWoolThunder"
sfxSolarBlaze="sfxSolarBlaze"
sfxSolarBlazePop="sfxSolarBlazePop"
sfxBlackHoleBomb="sfxBlackHoleBomb"
sfxBlackHoleBombOpen="sfxBlackHoleBombOpen"
sfxGeminiLaser="sfxGeminiLaser"
sfxHornetChaser="sfxHornetChaser"
sfxJewelSatellite="sfxJewelSatellite"
sfxTripleBlade="sfxTripleBlade"
sfxGrabBuster="sfxGrabBuster"
sfxFlashStopper="sfxFlashStopper"
sfxSlashClaw="sfxSlashClaw"
sfxWheelCutter1="sfxWheelCutter1"
sfxWheelCutter2="sfxWheelCutter2"
sfxWire="sfxWire"
sfxConcreteShot1="sfxConcreteShot1"
sfxConcreteShot2="sfxConcreteShot2"
sfxHomingSniper="sfxHomingSniper"
sfxHomingSniper2="sfxHomingSniper2"
sfxHomingSniper3="sfxHomingSniper3"
sfxHomingSniperLock="sfxHomingSniperLock"
sfxRainFlush="sfxRainFlush"
sfxSparkShock="sfxSparkShock"
sfxTenguBlade="sfxTenguBlade"
sfxSuperArm="sfxSuperArm"
sfxIceSlasher="sfxIceSlasher"
sfxPowerStone="sfxPowerStone"
sfxSkeletuppinPakkajoe="sfxSkeletuppinPakkajoe"
sfxTimeStopper="sfxTimeStopper"
sfxFakeTimeStopper="sfxFakeTimeStopper"
sfxError="sfxError"
sfxMenuMove="sfxMenuMove"
sfxMenuSelect="sfxMenuSelect"
sfxMenuScrollUp="sfxMenuScrollUp"
sfxMenuScrollDown="sfxMenuScrollDown"
sfxPause="sfxPause"
sfxTextBox="sfxTextBox"
sfxDebugMenu="sfxDebugMenu"
sfxDoor="sfxDoor"
sfxDoorEnter="sfxDoorEnter"
sfxUnlocked="sfxUnlocked"
sfxClamp="sfxClamp"
sfxLargeClamp="sfxLargeClamp"
sfxCastlePath="sfxCastlePath"
sfxBeat="sfxBeat"
PL_LOCK_MAX=14
PL_LOCK_AERIAL=13
PL_LOCK_GROUND=12
PL_LOCK_CHARGE=11
PL_LOCK_JUMP=10
PL_LOCK_SPRITECHANGE=9
PL_LOCK_CLIMB=8
PL_LOCK_PAUSE=7
PL_LOCK_SLIDE=6
PL_LOCK_SHOOT=5
PL_LOCK_GRAVITY=4
PL_LOCK_SPAWN=3
PL_LOCK_TURN=2
PL_LOCK_PHYSICS=1
PL_LOCK_MOVE=0
DEBUG_SPAWN=true
DIFF_EASY=0
DIFF_NORMAL=1
DIFF_HARD=2
EV_COMBINE=3
EV_BOSS_CUTSCENE=6
EV_REFLECTED=7
EV_ATTACK=8
EV_HURT=9
EV_DEATH=10
EV_GUARD=11
EV_WEAPON_SETUP=12
EV_WEAPON_SETDAMAGE=13
EV_WEAPON_CONTROL=14
EV_SPAWN=15
WL_VERBOSE=0
WL_ERR=1
WL_SHOW=2
gravAccel=0.25
waterAccelMod=0.57
MAX_SLOPE=2
